8 5 5 5 5 5 5 5 5 5 5 5 5 5 9
0 0 0 0 0 0 0 0 0 0 0 0 0 0 0 
0 0 0 0 0 0 0 0 0 0 0 0 0 0 0
0 0 0 0 10 0 0 0 0 0 0 0 0 0 0
0 0 0 10 10 0 0 10 0 0 0 0 0 0 0
0 0 10 10 10 0 10 10 0 0 0 0 0 0 0
6 2 2 2 7 0 6 2 7 0 6 2 2 2 7
3 1 1 1 4 0 3 1 4 0 3 1 1 1 4
3 1 1 1 4 0 3 1 9 0 3 1 1 1 4  