5 5 5 5 5 5 5 1 1 1 1 5 5 5 9
0 0 0 0 0 0 0 8 5 5 9 0 0 0 0 
0 0 0 0 0 0 0 0 0 0 0 0 0 0 0
0 0 0 0 0 0 0 0 0 0 0 0 0 0 0
0 0 0 6 2 7 0 0 0 10 0 0 0 0 0
0 0 0 3 1 4 0 0 0 0 0 0 0 0 0
2 2 2 1 1 1 2 7 0 0 0 6 2 2 7
1 1 1 1 1 1 1 4 0 0 0 3 1 1 4
1 1 1 1 1 1 1 4 0 0 0 3 1 1 9  